......a......
.....bcd.....
....efghi....
...jklmnop...
....qrstu....
.....vwx.....
......y......
......z......