....... .......
....... .......
....... .......
....... .......
....... .......
......   ......
.....     .....
               
.....     .....
......   ......
....... .......
....... .......
....... .......
....... .......
....... .......