......s......
......l......
......e......
......d......
......a......
......d......
iaawalrzwanen
......a......
......a......
......m......
......n......
......e......
......d......
......r......
......o......
......o......
......w......
......n......
......e......
......e......
......g......
.............